111111111111111
100000000000001
10000P00C00E001
111111111111111